111111111111
10000001CEP1
111111111111