111111
1P0C11
1E0011
111111
1111