1111111111111111111
100000000C000E00001
1011110111011110101
10C001000000001C001
1010111011101011101
101000P000000000101
1110111010111011101
100000000C000000001
1011111110111111101
10C000000000000C001
1111111111111111111