111111
1P0C11
1E0011
110111
111111
100001
111111