111111111111
10C000000001
100000000001
100001000001
100E000000P1
111111111111