111111111111
10C000000001
100000010001
100000000001
100001000001
100000000001
1000E00000P1 
111111111111